#.##########
#.#...##...#
#.#.#.##.#.#
#...#.##.#..
#####.##.###
#.....##...#
#.########.#
#..........#
############